111111111111111111111111111111
1E00000R000R000C00000C00000C01
101001010010R00010100100R00001
1010010010101010R01R01000R0001
1P0000000C00C000000000R000C001
1000000R000R000C00000C00000C01
101001010010R00010100100R00001
1010010010101010R01R01000R0001
100000000C00C000000000R000C001
1000000R000R000C00000C00000C01
101001010010R00010100100R00001
1010010010101010R01R01000R0001
100000000C00C000000000R000C001
101001010010R00010100100R00001
1010010010101010R01R01000R0001
111111111111111111111111111111