111111111111111111111111111111
1C0000000110000000000000000001
100001000110111111111111111101
1111011111100000000000001C0001
100001101110111111111010111111
101111100010110000001010001111
100000101010111101101011101111
111101111000100101001111101111
1P00000000111E0001011100001111
111111111111100111010001100001
101000010001111110011111111101
100011000101111110111000011101
110111111100000000100011011101
100000001101111111111011000101
1C11011011000000000000011100C1
111111111111111111111111111111