111111111111111111111111111111
1C0000000110000000000000000001
100001RRR110111111111111111101
1111011111100000000000001C0001
1000011R1110111111111010111011
1011111R00101R0000001010001011
1000001R1010111101101R11100011
111101111000100101001111101R11
1P00000000111E0001011100001111
11111111111110011101R001100001
1R0000010001111110011111111101
1000R1000101000R10111000011101
1101111111000R00001R0011011101
1000R0001R01111111111011000101
1R10001C11000000000000011100C1
111111111111111111111111111111