111111111111111111111111111111
1P100010100000100000000C100011
101010101010111011111111111011
100010001010001010100010000001
101110101011111010111010111011
101000100010000010000010001001
111110111111111011101011101111
101000100000101010101000001011
101110101111101010101111111011
101000000000100010001010101001
101011111110111011101010101011
100000001010100010000000000001
111110101010111010111011101111
1000001000100000000010100000C1
1E10001000100000000010100000C1
111111111111111111111111111111