1111111111111
1P0EC00010C01
1111111111111