1111111111111
1P0EC00000001
1111111111111