1111111111111
1ER0000000001
1000000C00001
1000000000001
10000000000P1
1111111111111