1111111111111
10000100000C1
1000010000001
1P000100000E1
1111111111111