1111111111111
10000R00000C1
10000R0000001
1P000R00000E1
1111111111111